0xff0000
0x636363
0x0000ff
0x00ff00
0x000000